..................................
.#################################
.#...............................#
.#...............................#
.#...............................#
.#...............................#
.#...............................#
.#...............................#
.#...............................#
.#...............................#
.#...............................#
.#...............................#
.#...............................#
.#...............................#
.#...............................#
.#...............................#
.#...............................#
.#...............................#
.#...............................#
.#...............................#
.#...............................#
.#...............................#
.#...............................#
.#...............................#
.#...............................#
.#...............................#
.#...............................#
.#...............................#
.#...............................#
.#...............................#
.#...............................#
.#################################
..................................
..................................
..................................