..................................
.################################.
.#..............................#.
.#..............................#.
.#..............................#.
.#..............................#.
.#..............................#.
.#..........#######.............#.
.#..........#...................#.
.#..........#...................#.
.#..........######..............#.
.#..........#...................#.
.#..........#...................#.
.#..........#...................#.
.#..............................#.
.#.........#######..............#.
.#............#.................#.
.#............#.................#.
.#............#.................#.
.#............#.................#.
.#.........#######..............#.
.#..............................#.
.#..............................#.
.#.........########.............#.
.#............#.................#.
.#............#.................#.
.#............#.................#.
.#............#.................#.
.#............#.................#.
.#..............................#.
.#..............................#.
.################################.
..................................
..................................
..................................