..................................
.################################.
.#..............................#.
.#..............................#.
.#..............................#.
.#..............................#.
.#..............................#.
.#..............................#.
.#..............................#.
.#..............................#.
.#..............................#.
.#..............................#.
.#..............................#.
.#..............................#.
.#..............................#.
.#..............................#.
.#..............................#.
.#..............................#.
.#..............................#.
.#..............................#.
.#..............................#.
.#..............................#.
.#..............................#.
.#..............................#.
.#..............................#.
.#..............................#.
.#..............................#.
.#..............................#.
.#..............................#.
.#..............................#.
.#..............................#.
.################################.
..................................
..................................
..................................